11*20
-
CWWWWTWWWWWWWWTWWWWC
W:...W........W....W
W.WW.W.WWWWWW.W.WW.W
W.W..............W.W
W.W.WW.WW//WW.WW.W.W
W......WG//GW......W
W.W.WW.WWWWWW.WW.W.W
W.W..............W.W
W.WW.W.WWWWWW.W.WW.W
W....W........W...:W
CWWWWTWWWWWWWWTWWWWC
-
P[8][20]
-
G[7][8]
G[7][10]
G[1][2]