7*20
-
CWWWWWWTWWWWTWWWWWWC
W......WG//GW......W
W.WW...WW//WW...WW.W
W.W:.W........W.:W.W
W.WW.W.WWWWWW.W.WW.W
W..................W
CWWWWTWWWWWWWWTWWWWC
-
P[5][9]
-
G[1][8]
G[1][11]
