%%%%%%%%%%%%%%%%%%%%%%%%%
%o .. P .....    ..... o%
%  ..   ..  ..   ..  .. %
%  ..   ..  ..   ..  .. %
%  ..   .....    .....G %
%  ..   ..  ..   ..     %
%  ..   ..  ..   ..     %
%o ..   .....    ..    o%
%%%%%%%%%%%%%%%%%%%%%%%%%
